NO textures/wall_1.xpm
SO textures/wall_2.xpm
WE textures/wall_3.xpm

EA textures/wadsall_4.xpm


1111111111111111111111111111111111111111111111111
1000000000000000000000000000000000000000000000011
1000000000000000000000000000000000000000000000011
1000000000000000000000000000000000000000000000011
1000000000000000000000000000000000000000000000011
1000000000000000000000000000000000000000000000011
1000000000000000000000000000000000000000000000011
1000000000000000000000000000000000000000000000011
1000000000000000000000000000000000000000000000011
1000000000000000000000000000000000000000000000011
1000000000000000000000000000000000000000000000011
1000000000000000000000000000000000000000000000011
1000000000000000000000000000000000000000000000011
1000000000000000000000000000000000000000000000011
1000000000000000000000000000000000000000000000011
1000000000000000000000000000000000000000000000N11
1111111111111111111111111111111111111111111111111
