R 848480
NO textures/wall_1.xpm
SO textures/wall_2.xpm
WE textures/wall_3.xpm

EA textures/wadsall_4.xpm

F 184,113,39
C 51,198,227

11111223
10010001
10040201
11410201
10000201
10000001
10N00001
11111111
